Governor ID,Governor Name,Power,Kill Points,Deaths,T1,T2,T3,T4,T5,Kills,Kills (T4+),Ranged Points,RSS Gathered,RSS Assistance,Helps,Alliance
20152080,el chico malo,163707062,5739217166,24556863,17796444,11726496,18415739,206996313,178428940,433363932,385425253,0,6306850192,9776588382,36714,[MC74]Masters of Courage
10433267,Rosemary705,133453013,3361834391,26456356,26040517,6446916,8698749,180882068,75005839,297074089,255887907,0,23102272705,4004964461,180479,[IKVA]Int Kor Vit Alliance
40922165,Rendant,111580007,505364214,6750310,18967132,301845,206162,12896537,18558854,50930530,31455391,0,22110145351,1939407268,34115,[~TB]~True Blood~
23509063,XBionicBlurryX,111247919,1731373229,15701209,43028657,7912074,4080145,84966391,42047943,182035210,127014334,0,16157802757,3437426323,61469,[MC74]Masters of Courage
22824323,GaMik,106389083,1025833854,7119792,28231202,702628,704857,39109587,31243353,99991627,70352940,0,21718186728,4470508370,92702,[~TB]~True Blood~
21304542,?????,104444695,1751058096,13090604,4779493,2405434,4762260,112125733,30249248,154322168,142374981,0,21615344265,5755669994,33028,[~TB]~True Blood~
29886125,WhiteTigger,99051737,3529935029,17585811,45082786,1895701,2437080,129082009,110827933,289325509,239909942,0,16292615852,2521233255,79930,[MC74]Masters of Courage
41110873,Lacsar,99033351,317380721,4750156,152658,147463,36966,6565892,12562424,19465403,19128316,0,37156494759,7184830346,35061,[MC74]Masters of Courage
40925618,Nitmare01,97130697,191281539,4547465,1907335,2584805,311673,8275891,5086243,18165947,13362134,0,11891714112,3094150970,27453,[~TB]~True Blood~
61170341,Rafiki Prime,90994144,1894451967,21101162,134668709,1857879,1734322,71985292,56850613,267096815,128835905,120705,19504879202,6147163547,119403,[MC74]Masters of Courage
60305726,SmokyDread,89722756,368381496,11716522,445791,315155,388352,10357198,13126832,24633328,23484030,87821,14448649708,9117847487,58536,[MC74]Masters of Courage
48611614,Cengiz?Han,88759179,901217315,13608201,67821226,2445191,1839337,37634118,24953208,134693080,62587326,0,21795868666,3201268679,39742,[MC74]Masters of Courage
40962537,AHMED HERZALLAH,87573421,186591808,6242930,1891900,318254,431750,4878450,6753271,14273625,11631721,0,8682184241,556073000,13401,[~TB]~True Blood~
40989465,????,86885000,175085094,12280941,696320,824650,1036545,11920617,2497209,16975341,14417826,0,16087095197,914795076,55591,[PE-A]PeacefulExit Academy
40984308,PodzAdPinkAdam,86336694,559276286,22553817,161980102,1516046,1343131,20508281,15669642,201017202,36177923,0,14748263142,1180957496,82176,[IKVA]Int Kor Vit Alliance
40997355,AceKing2K,85193273,356412094,8598643,1190172,1487250,734430,12028436,11498874,26939162,23527310,0,11153710311,1440058834,16521,[MC74]Masters of Courage
40928263,????,84743331,611229329,6654613,687337,497412,605167,14464535,23151551,39406002,37616086,0,31363900481,1485230000,91418,[MC74]Masters of Courage
40958747,AHMED1977,82680360,290309073,13316765,32612038,542243,309745,13516056,7315132,54295214,20831188,0,28091896459,139200000,111686,[~TB]~True Blood~
66527265,Errebi,82431887,80190592,3570120,57260,62658,21261,1461760,3267559,4870498,4729319,0,31016381590,10313000000,11208,[MC74]Masters of Courage
40914960,LifeisBeautiful,81781748,415657210,4188669,63237713,3113898,3011793,10728864,13872303,93964571,24601167,0,12651754232,3085107629,44555,[~TB]~True Blood~
26321575,Lemi B Salty,81242927,358141011,12557116,1162485,559681,2665728,14385052,10113786,28886732,24498838,0,15190008362,6896492206,62448,[MC74]Masters of Courage
20927198,Axios Elysium,80298902,453758476,14339637,46424131,205575,111685,29469378,7446099,83656868,36915477,0,13636772008,2630326101,104594,[MC74]Masters of Courage
40939667,RaptorBite,79879219,654167546,20095377,1045300,254583,722115,33841670,15607208,51470876,49448878,0,18698947196,864651006,82700,[~TB]~True Blood~
23686212,King Koneru,77795165,1563272768,14152288,11683592,1114919,1375143,57086388,49117088,120377130,106203476,0,18011085785,8431075423,115636,[~TB]~True Blood~
23886718,Rosèmàry705,75598374,299992281,10991285,692576,554913,1549065,13978840,7637964,24413358,21616804,0,11350448299,5437166231,19977,[~TB]~True Blood~
46815562,Rendant Jr,75028370,139878886,4522738,638562,11304,21104,3286787,5338814,9296571,8625601,0,21705625648,10144400000,17618,[~TB]~True Blood~
1665246,Jadis of Narnia,73942968,66656369,10348296,14665,46173,116320,2378595,2115493,4671246,4494088,0,9641880950,3950867873,25818,[~TB]~True Blood~
64153878,Dìldo Swaggins,73468031,109750753,3124096,1430545,2227994,1719799,5402646,2205150,12986134,7607796,0,7772027016,4511233289,18860,[MC74]Masters of Courage
15540748,alom??,73392177,651365015,13351662,64361268,555854,171796,26641903,18513742,110244563,45155645,0,15688556053,7752649717,87802,[~TB]~True Blood~
27904876,ClodoMiro,71726769,59560409,10331091,3127318,251314,41727,1839621,1993460,7253440,3833081,0,15964612763,1907993695,25272,[MC74]Masters of Courage
41068925,Karib1,66961899,59247432,10935275,156554,412765,330358,2606508,1550204,5056389,4156712,0,9012613729,3070720920,19927,[~TB]~True Blood~
44415443,???44415443,66731252,35826490,6421400,1966493,336824,12401,814648,1328173,4458539,2142821,0,15309143550,4619344113,6357,[PE-A]PeacefulExit Academy
46166732,GariBaza,66623120,154522133,9268652,62395739,365129,156617,4583370,4742628,72243483,9325998,0,8559557729,903770362,27212,[SRO9]Passport and Farmer
43001521,2AHMED1977,65967330,69716092,8166081,4874921,26276,33384,2251280,2302111,9487972,4553391,0,20655348101,1154880897,40257,[~TB]~True Blood~
40931180,Nigol78,65314358,63428160,5849350,2022152,323120,57335,2291031,1961892,6655530,4252923,0,6028018759,1331508126,29055,-
41019532,skdjfhrbf,65200592,10554104,6670055,17303,6449,30149,324355,358680,736936,683035,0,12852068697,587435102,1837,[HAZE]Haze Gang
40832003,33 M4X,64263000,85576277,698931,421728,466771,537105,5697381,1271808,8394793,6969189,0,12903561612,1475000000,52766,[~TB]~True Blood~
50569495,AQ1947,62823531,213118890,6614382,953811,1155431,664684,10080031,5357911,18211868,15437942,0,10526928163,2785350099,45192,[MC74]Masters of Courage
106810107,En?ch,62590614,292579879,4402202,2186418,2617566,3730266,13075148,7061746,28671144,20136894,9045,10082721896,1755109310,31169,[MC74]Masters of Courage
21332733,Armageddon Army,60786477,105735140,10965470,1654814,205397,203981,5092570,2662588,9819350,7755158,0,11151809486,1320573048,23500,[~TB]~True Blood~
24836505,Càndy Shop,60563501,250770993,8858665,551556,321033,511119,10570250,7113582,19067540,17683832,0,9971425346,18887699932,14985,[~TB]~True Blood~
29270501,Jadis child,57152084,19556618,5841637,20261,112866,382116,354709,712564,1582516,1067273,0,6421103232,1280411401,11862,[~TB]~True Blood~
23697905,???mondo,53635315,154909505,7280863,418447,713423,799590,5437951,4791055,12160466,10229006,0,13601981166,11031914436,3777,[~TB]~True Blood~
41151325,EatPickle,52690872,17190181,4314063,4506,39033,25381,145439,777765,992124,923204,0,25034060384,0,3866,[DF69]Special Duck Forces
53509314,Sterling A,52218868,17745790,2951124,5442,3277,512,446726,663442,1119399,1110168,0,4939815860,1378903283,9838,[~TB]~True Blood~
119109140,Lemi B Daring,51564031,88689959,4544024,684219,662019,623322,6046805,1213387,9229752,7260192,0,7529088054,7635114231,26874,[~TB]~True Blood~
64040422,Monsieur Rafiki,50034551,76182624,3805688,35170,1498,117046,1812641,2878900,4845255,4691541,0,19705466764,25401540944,13101,[~TB]~True Blood~
127530244,Cengiz?HanJR,49705155,122590847,2081659,1370948,425413,263183,3127320,4456995,9643859,7584315,257033,6397756640,861358393,6785,[~TB]~True Blood~
33448118,MaggieGreeneè,47199142,42774413,2349776,292258,298368,171544,2337743,902781,4002694,3240524,0,6154163291,2622688355,4648,[~1st]~First Blood~
41021385,Sharpi,46845519,2225080,1707701,51113,41195,5987,3808,103522,205625,107330,0,4157119973,0,502,[NWM']Nueva Orden
41080561,flyblack,44550820,7544171,1960486,114678,82510,16894,220820,254022,688924,474842,0,6534569402,20430577,10796,[~TB]~True Blood~
41017112,Der Die Das,44530868,24012099,7480884,520188,11071,52070,513428,927168,2023925,1440596,0,3791366841,0,6090,[~TB]~True Blood~
78595609,??? 2,43530928,4190098,1762170,37983,112663,55939,140866,116238,463689,257104,0,2639606511,884597273,6571,[~TB]~True Blood~
33745401,CärolDîxon,42917256,62941086,2990106,35462,54486,713168,2967689,1514773,5285578,4482462,0,4944340200,932009421,5016,[99cd]Crimson Dragons
40960077,10061970,41605871,34130620,13793187,175594,45714,55711,840121,1269001,2386141,2109122,0,3627648202,1155462,2674,[DF69]Special Duck Forces
40934435,Link1666,41458463,49534354,7789633,4544913,2969169,770066,1553437,1203620,11041205,2757057,0,7812118651,9410826203,37361,[~TB]~True Blood~
149505790,Jubitora,41328376,96977314,2938793,2518633,1930045,765927,4980757,1987111,12182473,6967868,0,4668925536,383653552,15289,[MC74]Masters of Courage
160654829,ŒCB,40868541,99468838,2160540,2358562,688774,445342,5267637,2158092,10918407,7425729,0,6573176228,1859088009,16365,[~TB]~True Blood~
15794649,xXxBluRRYxXx,40747727,86240481,3569999,119548,304894,269851,2316678,3068030,6079001,5384708,0,5112331372,717002143,6628,[~TB]~True Blood~
37393423,General ALPHA,39718068,24527954,4646005,739000,728180,277786,1371961,404652,3521579,1776613,0,5158309590,161362844,15037,[~TB]~True Blood~
62705356,Rafiki Jr,39679197,29456949,3021937,67436,30715,19758,601934,1164183,1884026,1766117,0,16869367103,11825845575,10936,[~TB]~True Blood~
46005845,RickGrimeS,39424482,10429905,1516838,12345,5884,7287,690262,174195,889973,864457,0,4934041126,548962219,3147,[M599]TheFaeWild
21872885,NitramX,39219515,4823460,2258390,42374,10905,2919,312506,82822,451526,395328,0,4023870709,161468058,15056,[~TB]~True Blood~
27410440,King Koneru 2,38578590,79568885,4093794,862256,13734,27614,3700727,2112562,6716893,5813289,0,14088338324,10866339821,16822,[MC74]Masters of Courage
33508521,JohnWICK1,37781163,4809781,1686961,5827,0,11049,395248,40597,452721,435845,0,4379079158,33239960,2284,[~IP]"Important Person"
110925956,Enoch 4,37752337,22861630,2315389,1644402,511049,665303,1387838,248553,4457145,1636391,0,5283995615,1359117879,5275,[~TB]~True Blood~
67535192,Dame tu boca,36146210,6200696,2545289,316624,519483,23474,173181,163635,1196397,336816,0,4402945172,2038285791,14027,[~TB]~True Blood~
64043900,Lemi B Sweet,35692536,2655723,2017051,14347,5982,1085,239407,12124,272945,251531,0,7002326905,7164105964,8059,[~TB]~True Blood~
28469676,Mini Clodo,35400759,11613923,5639836,295045,130428,1697,488607,320060,1235837,808667,0,10709186533,3005328185,9854,[~TB]~True Blood~
67306994,DarrylDixon,33060954,10124311,1693169,80627,28824,14922,557307,220889,902569,778196,0,4364569717,366012365,7820,[EV99]Emerald Valkyrie
41003447,Buddha is life,31564506,11188838,6343158,39154,113675,52452,87577,493404,786262,580981,0,2246885389,96859998,1464,-
62362414,1Clark1,31548815,4573613,2160377,22706,1714,16,35140,210709,270285,245849,0,2261779806,250210181,1957,[KIJB]radgd IJyuo)
83079418,SmokyDread2,31294888,6354830,1280108,13612,30581,1559,210307,209082,465141,419389,0,2645260348,3234086039,2936,[~TB]~True Blood~
37783566,WhiteTigger 1,31144607,112986369,5078886,207379,206275,148816,4028216,3582746,8173432,7610962,0,10439815134,12227255213,6605,[~TB]~True Blood~
41377688,showmethemone,30846572,9060381,182706,321616,770725,252437,615088,14699,1974565,629787,0,3575940410,79661122,11344,[~1st]~First Blood~
21292925,XBlurryFaceX,30084781,31079123,2367022,77856,51830,188788,1013264,1003605,2335343,2016869,0,3157301265,780034759,6044,[99cd]Crimson Dragons
46936164,IamNegaN,29926600,8233901,3213105,162359,211828,3071,338473,219038,934769,557511,0,4254495527,15270548,2899,[K!{l]The Killhouse
10464969,WhiteTigger 2,29462504,116465458,4555917,191991,161269,111568,4533227,3516299,8514354,8049526,0,10053685148,11074314382,7098,[~TB]~True Blood~
43915163,Steamed Bunn,29031051,7047116,297420,4042,36346,889,21204,337901,400382,359105,0,3325851108,487713554,1615,[~TB]~True Blood~
59266248,Legatus Rafiki,28653099,12279964,2582507,16452,44390,4891,236633,490100,792466,726733,0,19031181279,16986522962,5234,[M599]TheFaeWild
71188633,Aureus Rafiki,28514846,7162661,3320281,1138,2817,8285,221066,245650,478956,466716,0,15334990357,14169096564,5697,[~TB]~True Blood~
69476065,LittleDilSwag,25033852,4947814,960109,157472,345928,321356,150306,71799,1046861,222105,0,3547472817,2708398217,4043,[~TB]~True Blood~
67340655,WhiteTigger 3,24392438,76646649,3520200,376736,447732,153972,2412391,2546802,5937633,4959193,0,8364842997,9894677143,6822,[~TB]~True Blood~
14958429,Lemi B Fearless,24008523,293033,107838,3286,38,380,29078,0,32782,29078,0,2749824072,471344914,4636,[~TB]~True Blood~
75731100,Hádes Rules,22785987,2145020,1435562,0,0,0,108962,52770,161732,161732,0,2356385905,393729187,1613,[DF69]Special Duck Forces
17998242,Ashraful??,22030972,31079765,4469814,12155,37534,8219,2103817,496561,2658286,2600378,0,7094072386,6931032693,4885,[~TB]~True Blood~
53543225,Pawsitivë,21377966,4683629,1122862,14929,18218,76017,434014,0,543178,434014,0,2489566755,342924900,5555,[DF69]Special Duck Forces
31073821,7363gwgw6t3,21185584,1241871,131859,52335,296429,84,21787,21017,391652,42804,0,1913035098,962806977,845,[~TB]~True Blood~
60775515,King Koneru 3,19170979,7814558,1025292,18672,36129,11239,416735,176313,659088,593048,0,6431951620,5231897385,2791,[~TB]~True Blood~
93304921,WhiteTigger 4,18821684,31300003,1885723,51755,6339,3546,970353,1077963,2109956,2048316,0,5384710004,5087991671,2793,[~TB]~True Blood~
124021929,Lamonius Rae,18575159,8950174,1135438,2973,7899,11613,877561,5586,905632,883147,0,4369695225,2551537659,3850,[Eiyy]DarkGuilder
41062624,Governor41062624,17290251,4845248,2824646,177474,293979,20074,281706,66222,839455,347928,0,2427698768,19635612,2683,-
136121131,Enoch 5,16995543,1135824,1161269,6370,46,12317,47411,30554,96698,77965,0,2710744521,923807848,948,[~TB]~True Blood~
34855374,GaMic,16642639,2670853,1490850,164778,179,15,125542,69103,359617,194645,0,5272554244,873456620,5120,[~1st]~First Blood~
128157927,thiênnnn,16335540,132628,0,8061,15478,19460,2222,0,45221,2222,0,7670800374,7243140809,732,-
102533250,Enoch 2,15499028,10536027,1093413,415747,2015331,1074449,156130,28156,3689813,184286,0,2289018957,1207694468,3454,[~TB]~True Blood~
